   ############################
   #        #                 #
#  #  ####  #  #  ####  ####  #
#     #     #  #  #  #  #     #
#  #  ####  ####  #  #######  #
#  #     #  #  #     #     #  #
#######  ####  #######  ####  #
#              #     #        #
#  ####  #  #  #  #  #  #######
#  #  #  #  #     #  #        #
####  ##########  ####  #  ####
#                       #     #
#  ####  #  #  #  ####  ####  #
#  #  #  #  #  #     #     #  #
####  #  #  #  #######  #  ####
#        #  #  #     #  #     #
####  #  #######  #######  ####
#     #     #  #        #     #
#  ####  ####  #  #######  #  #
#     #     #              #  
############################  