   ####################################################################################################################################################
            #              #  #  #        #                 #     #     #           #        #                 #        #              #     #  #     #
#  ####  #  #######  ####  #  #  #  #  #  #  #  #######  ####  #######  #  #  ####  #  #  #  ####  ##########  #  #  #  #  #  #  #######  ####  #  ####
#  #  #  #  #     #  #           #  #  #     #  #  #     #        #  #     #     #     #  #  #  #           #  #  #  #     #  #     #                 #
#  #  #  #  #  #  ####  ####  #  ##########  ####  #  #  #  #######  #  #  #  #  #  #  ####  #  #  ####  #######  ####  #  #  ####  ####  #############
#  #  #  #  #  #        #     #        #  #  #  #     #  #        #     #  #  #  #  #  #  #  #        #  #     #  #  #  #  #     #  #              #  #
#  #  ####  ####  ####  ####  #  #  ####  ####  ####  ##########  ####  #######  ####  #  #######  #  #  #  ####  #  #######  ####  #  #  ####  ####  #
#        #     #  #     #  #  #  #  #     #        #  #  #  #  #              #     #  #        #  #  #  #  #  #     #           #     #  #           #
#  #  #######  #######  #  #######  #  ####  #  ####  #  #  #  ####  ######################  #  ####  ####  #  #######  #  #######  ####  #######  #  #
#  #  #     #     #     #  #  #        #  #  #  #     #        #        #  #  #  #     #  #  #  #                       #     #  #  #  #  #        #  #
####  #  #  #######  #  #  #  #######  #  ####  ####  ####  #######  #  #  #  #  ####  #  #  ##########  #######  ####  #  #  #  ####  ####  #  #  ####
#  #     #  #  #     #     #  #        #        #     #  #           #  #        #        #        #     #        #     #  #  #     #     #  #  #     #
#  #  #######  #######  ####  ####  ##########  #  #  #  #  ##########  ####  ####  ##########  ##########  #######  #######  #  ####  ####  ####  #  #
#     #     #  #        #  #           #        #  #        #                 #  #  #     #        #     #        #     #     #     #  #        #  #  #
####  #  ####  ####  ####  ####  ####  #  #############  ##########  #######  #  #  #  ####  ####  #  #######  #  ##########  ####  #  ####  #  #  ####
#  #        #        #     #     #     #     #           #     #     #  #  #     #        #  #  #        #     #  #           #  #     #  #  #  #     #
#  ####  #  #  #######  #  #  #######  #  #  #############  #  ####  #  #  #  ##########  #  #  #######  ####  #  ##########  #  ####  #  ####  ####  #
#     #  #        #     #  #     #        #        #  #     #     #        #  #     #           #           #  #  #                    #           #  #
#  ####  #############  ##########  ####  #  #  ####  ##########  ##########  ####  #######  ##########  #  #  #######  #######  #  ##########  #######
#        #  #     #                 #  #  #  #     #           #  #  #              #           #     #  #     #        #  #  #  #  #        #     #  #
####  #  #  #  #  #######  #######  #  ################  ####  #  #  ####  #######  #  #############  ##########  #  #  #  #  #######  #  #######  #  #
#     #  #     #     #  #     #           #     #     #  #              #  #  #     #     #     #     #  #        #  #  #  #     #  #  #  #           #
#  ####  ####  ####  #  ##########  #  #  ####  #  ####  #  ####  #  #######  #  #  #  ####  #######  #  ################  #  ####  #  ####  ##########
#     #        #  #  #  #        #  #  #     #        #  #  #     #  #           #                    #     #  #        #  #     #        #  #        #
#  #######  ####  ####  ####  ####  ####  ##########  #  ####  #  ####  #  #  ####  ####  ################  #  #######  #  #  ####  ################  #
#  #  #        #  #              #     #     #  #        #     #  #     #  #  #     #  #     #                 #              #     #  #           #  #
#  #  ##########  #######  ####  #  ####  ####  #  ####  #  #  #  #  #  ####  #######  ####  #  ####  ################  #######  ####  ####  ####  #  #
#        #  #           #     #  #     #  #  #        #  #  #  #  #  #  #           #     #  #  #     #  #  #  #           #        #  #  #  #        #
#  #######  #  ####  ####  #  ####  ####  #  #  #######  ##########  ####  ####  ####  ####  #######  #  #  #  ####  #  #  #  #  ####  #  #  #  #  ####
#  #     #  #     #     #  #           #  #     #     #                 #     #           #     #        #     #  #  #  #  #  #  #  #  #  #  #  #  #  #
#  #  ####  #  ####  ####  ####  ####  #######  #  #  ####  #########################  #############  #######  #  #######  ####  #  #  #  #  #######  #
#     #  #     #  #     #  #        #     #        #  #           #  #              #     #              #  #        #  #                 #     #  #  #
#  ####  ####  #  ####  ####  #  #  #  #  #  ####  ##########  ####  #############  #  #######  ##########  #  #######  #######  ##########  #  #  #  #
#     #           #     #     #  #  #  #        #     #     #  #     #        #  #        #     #  #     #        #                    #     #        #
#  ####  ##########  ##########  #######  #  ####  #  #  ##########  #  #######  #  ####  ####  #  ####  #  #######  ####  ##########  #  #  #######  #
#        #        #     #     #     #     #  #     #           #  #              #     #  #  #           #        #     #        #  #     #     #  #  #
#  ####  ####  #  #  ####  #  #  #  #  ####  ####  #  ####  ####  #  ####  #  #  ####  #  #  ####  #######  ################  ####  ####  #######  ####
#     #  #     #  #     #  #  #  #  #  #  #     #  #     #  #        #  #  #  #  #     #  #  #           #     #     #     #     #  #        #        #
#######  #  #  #######  #  ####  #######  ##########  ####  #  #######  #  #  #  #  #  ####  #######  #  #  #  ####  ####  ####  #  ####  #######  #  #
#     #  #  #     #     #     #     #  #  #  #        #  #  #     #     #  #  #  #  #     #  #        #  #  #  #           #        #  #  #     #  #  #
####  #######  #  ####  #  #######  #  #  #  ####  ####  #  #  #  ####  #  ##########  ####  #  #  ##########  #######  ####  ####  #  #  ####  #  ####
#              #              #        #     #           #     #     #     #        #        #  #  #                 #        #  #  #     #           #
###################  #  #############  #  #  #######  #  ####  #  ##########  #  #  #  #######  ####  #######  ####  #  #######  ####  #  #  ##########
#  #     #     #  #  #     #              #        #  #  #  #  #        #     #  #  #     #           #     #  #  #  #  #  #     #     #     #     #  #
#  ####  ####  #  #  #  ####  #  ####  #  #  #############  #  #############  ##########  #  #  #  #  #  #  ####  #  ####  ####  #######  #######  #  #
#     #        #     #  #  #  #     #  #  #     #                 #  #                       #  #  #  #  #        #  #  #  #  #        #     #  #     #
####  ####  #  #  #######  #  ################  #  #  #######  #  #  ####  ##########  #########################  #  #  #  #  ####  ####  #  #  #  #  #
#        #  #     #  #  #     #  #     #        #  #     #     #     #              #        #  #     #     #  #              #        #  #        #  #
#  #  ####  ####  #  #  #  #  #  #  ####  #  #######  ##########  ####  #######  #  #######  #  #  #######  #  ####  ####  #  ####  #######  #######  #
#  #        #     #     #  #        #  #  #  #     #     #  #        #  #  #     #     #           #     #  #  #  #     #  #  #  #              #     #
##########  ####  #  ##########  #  #  #  ####  ####  #  #  ####  ####  #  ####  #  ####  ####  ####  ####  #  #  ####  ####  #  ####  #  ##########  #
#     #  #  #     #     #     #  #  #  #  #     #     #     #  #  #     #     #  #     #     #  #                 #     #  #        #  #     #  #  #  #
#  ####  #######  ####  #  #  #  #  #  #######  ####  #######  #  #  ####  #######  ##########  #  #######  #  ##########  ####  #######  ####  #  #  #
#  #  #  #     #  #  #     #  #  #     #     #  #     #  #  #  #  #     #              #  #  #     #     #  #  #     #  #     #     #     #  #  #     #
#  #  #  #  ####  #  #######  #  #######  ####  #  ####  #  #  #  #  #  ####  ##########  #  #  ####  #######  #  ####  #  ####  ####  #  #  #  #  #  #
#              #  #           #  #        #        #  #        #  #  #  #        #  #     #        #     #     #  #  #                 #     #     #  #
#  ####  #  #  #  #  ###################  #  ####  #  ####  #  #  ################  ####  #  #  #######  #  #  #  #  #######  #############  ####  ####
#     #  #  #  #  #  #     #     #  #     #     #  #  #  #  #           #        #        #  #           #  #  #  #              #  #        #  #  #  #
#  #  #  ####  #  #  #  ####  ####  #  #  ####  ####  #  #  #############  #############  #  ################  #  #  ##########  #  #######  #  #  #  #
#  #  #     #        #     #  #  #  #  #        #     #  #  #           #           #     #     #              #        #           #     #  #        #
#  #  #  ####  #  ####  ####  #  #  #  ##########  #  #  #  #  #  #######  ####  #  #  #  #######  #  ##########  #######  ####  ####  #######  #######
#  #  #     #  #     #  #        #     #  #  #     #  #     #  #  #     #  #  #  #  #  #     #     #     #     #     #  #     #  #     #           #  #
#  #  ####  #  ####  #  #  #  ##########  #  #######  #  #######  #  ####  #  ####  #  ####  ####  #  #######  #  #  #  #  ####  #  ####  #  #######  #
#  #  #  #  #     #  #  #  #        #  #        #  #                 #        #  #        #     #  #  #        #  #  #     #  #        #  #           #
####  #  #  #  #  #  #  #  #  #  ####  #  ####  #  ####  ##########  #  #######  #  ####  #######  #  ####  #######  ####  #  ###################  ####
#        #  #  #  #  #     #  #     #  #     #        #  #  #     #     #     #     #        #     #              #     #           #  #  #           #
#  #  #  ################  ####  ####  #  ####  ####  ####  ####  ##########  ##########  ##########  ####  #  ####  #  ####  ####  #  #  #  ####  ####
#  #  #  #        #     #  #        #     #  #     #           #           #  #        #  #  #     #     #  #  #     #  #        #  #  #     #        #
##########  ##########  #######  #######  #  #############  ##########  ####  #  ####  ####  #  ####  #  #  #  #  ####  #######  ####  #  #######  ####
#     #     #  #              #        #        #  #     #     #           #  #  #                    #  #  #  #     #  #  #     #              #     #
#  #######  #  #  #######  #######  ####  #  ####  ####  #######  #######  #  ####  #  ####  #  #  #  #############  ####  #  #############  #######  #
#              #        #  #        #     #           #                 #        #  #  #     #  #  #  #     #           #  #  #                 #     #
#######  ####  ####  #  ##########  #######  #  #######  #  ##########  ####  #  #  #  ####  #######  #  #######  #  ####  #######  ####  #  #######  #
#           #        #  #     #     #     #  #           #        #  #     #  #  #  #  #     #        #           #        #           #  #        #  #
#############  ####  #  ####  #  #  #  #######  ##########  ####  #  ######################  #######  ####  #  ####  #  #######  #  #  #  #  #  #  #  #
#           #     #  #        #  #           #  #     #     #              #  #              #  #     #  #  #  #     #  #     #  #  #  #  #  #  #  #  #
#  #  #  #  ####  #############  #  ####  ####  ####  #  ####  ####  ####  #  #  ####  #######  ####  #  #  ##########  ####  ################  #  #  #
#  #  #  #  #     #  #           #  #     #  #  #     #  #  #     #  #     #  #  #     #  #     #     #  #     #                 #     #     #  #  #  #
#  #############  #  #  ##########  ####  #  #  ####  ####  ##########  #  #  ##########  ####  #  ####  ##########  #  #  ####  ####  #  ##########  #
#           #  #  #  #     #           #        #  #        #  #  #     #        #     #           #        #        #  #  #  #  #                 #  #
####  ####  #  #  #  #  #############  ####  ####  #  ####  #  #  ####  #  #  ####  ####  #  ####  #  #  #  ####  #  #  ####  #  #  #  #  ####  #  #  #
#     #  #  #           #     #  #     #  #     #        #  #     #     #  #              #     #  #  #  #  #  #  #  #  #        #  #  #  #     #  #  #
#  ####  #  #  ##########  ####  #######  #  ####  #######  ####  ####  ##########  #############  ####  ####  ####  ###################  #######  #  #
#  #     #        #        #                    #  #  #  #                 #     #  #     #  #     #  #  #              #     #  #  #     #     #  #  #
####  ##########  #  ####  #  #  ####  #######  ####  #  ####  #######  #######  #######  #  ####  #  #  ####  #  #  ####  ####  #  #  #######  #  #  #
#     #           #  #     #  #  #  #        #     #           #           #                 #           #     #  #     #        #     #  #  #     #  #
#  #  #######  #  #  ####  #######  #  #######  #########################  ####  ####  #  #############  ####  ####  ####  #######  ####  #  #  ####  #
#  #           #        #  #  #           #  #        #              #  #     #  #     #  #           #  #     #  #           #     #        #     #  #
#  ##########  #######  ####  ####  #######  ###################  ####  ####  #######  #######  #############  #  #######  #  #  #  #  #  #  ####  #  #
#  #     #  #  #        #     #  #  #                 #        #     #  #           #     #     #     #        #           #     #  #  #  #     #  #  #
####  ####  #  #  ####  #  #  #  #  ##########  #############  ####  #  ####  ####  #  ####  ####  #  ##########  ####  #######  #######  #  #######  #
#     #     #  #  #  #     #     #        #     #     #        #  #     #     #                 #  #     #  #  #     #        #        #  #     #     #
####  #  #  #  ####  #  ####  ##########  ####  #  #  #######  #  #  ####  #######  #  #  ####  ####  #  #  #  ################  ####  #  #############
#     #  #           #     #  #  #     #  #        #     #        #        #        #  #  #  #        #  #  #  #  #           #  #                    #
#  #  #  ####  ##########  #  #  #  ####  #  ####  ##########  #######  #############  ####  #  #  ####  #  #  #  ####  #######  #############  #  ####
#  #     #           #     #     #        #  #        #     #        #           #     #     #  #     #  #              #  #     #     #  #  #  #     #
#  ####  #  ######################  ####  ####  #  #  ####  ####  ###################  ####  #  #  #######  ##########  #  ##########  #  #  #  ####  #
#  #     #                 #     #  #        #  #  #        #     #  #  #     #        #  #  #  #                    #  #           #           #  #  #
#  #  #######  ####  #  #  #  #  ####  #  #  #  ####  ####  #  #  #  #  #  ##########  #  #  #######  #######  ###################  #  ##########  #  #
#  #     #     #     #  #     #  #     #  #        #  #        #     #                          #     #        #                             #        
####################################################################################################################################################  
