   ##
      #              #     #  #
#  #######  #  ####  #  #  #  #
#           #     #  #  #     #
#  ####  #  #######  #  #  ####
#  #     #  #  #        #  #  #
####  #######  #  #  #  #  #  #
#     #  #  #     #  #  #  #  #
####  #  #  #######  #######  #
#              #              #
#  #  #############  ####  #  #
#  #  #     #     #  #     #  #
####  ####  ####  #  ####  ####
#     #     #     #     #  #  #
#  ####  #  #  ####  #######  #
#  #     #           #     #  #
##########  #######  #  ####  #
#           #     #     #  #  #
#  ####  #  #  #  #  #  #  #  #
#     #  #     #  #  #        
############################   